9 9 9 9 9 9 9 9 9 9 9 9 9 9 9 9 9 9 9 9 9 9 9 9 9 9 9 e
9 9 9 9 9 9 9 9 9 9 9 9 9 9 9 9 9 9 9 9 9 9 9 9 9 9 9 e
1 0 0 0 1 1 1 0 4 0 1 1 0 1 1 0 0 0 0 1 1 1 1 0 0 0 0 e
1 4 4 4 4 4 4 1 4 1 4 0 4 0 1 4 0 4 4 1 4 4 4 4 1 0 0 e
2 1 0 0 1 3 0 1 1 1 1 1 0 1 0 0 1 0 1 1 3 1 1 0 0 0 1 e
0 4 2 1 0 2 4 0 0 1 4 4 4 1 4 1 1 4 4 4 1 4 4 4 1 1 1 e
0 0 1 0 0 1 0 0 0 0 0 1 1 1 0 0 3 0 0 1 1 0 0 0 1 1 1 e
4 4 4 0 4 4 4 4 4 1 0 4 4 4 4 1 4 1 0 1 4 0 0 4 4 4 4 e
0 0 1 0 0 0 4 1 0 1 1 1 0 1 0 0 0 1 0 0 1 0 4 0 1 1 0 e
4 0 4 1 1 0 4 4 1 4 0 0 4 1 4 1 1 4 4 0 0 4 4 4 4 1 4 e
0 0 0 1 3 4 0 1 0 1 0 1 1 1 1 3 1 0 1 1 0 0 0 1 1 1 1 e
0 4 1 4 4 4 3 4 4 1 4 4 4 1 0 4 4 4 4 0 0 0 3 1 4 1 4 e
1 0 1 0 1 3 1 0 0 0 1 0 1 0 3 0 0 1 0 0 1 0 0 1 1 0 0 e
4 1 3 0 0 4 0 1 4 1 1 4 1 1 4 4 1 4 0 2 4 4 4 1 1 4 3 e
1 1 0 0 0 0 3 0 1 1 0 0 0 0 1 0 0 0 1 1 1 0 1 1 1 0 0 e
0 4 4 4 0 0 0 4 0 3 4 1 2 1 4 2 4 0 4 0 0 4 1 4 1 4 0 e
0 0 0 1 0 0 0 4 0 1 1 1 0 1 0 0 0 0 1 4 3 1 1 0 0 0 0 e
4 4 1 1 4 0 4 1 4 1 4 1 4 1 0 0 4 4 3 1 0 3 1 4 4 4 0 e
0 1 0 1 0 0 1 3 0 1 0 0 3 1 4 0 1 0 4 0 1 0 1 0 1 0 1 e
1 1 0 4 0 4 0 0 0 4 0 4 4 4 1 4 4 4 1 1 0 0 1 1 0 1 1 e
1 1 0 1 0 1 1 1 1 1 0 0 1 0 1 0 1 1 0 1 1 0 0 1 1 1 4 e
3 4 4 1 4 4 4 0 4 2 0 4 1 4 0 4 4 1 4 4 1 0 4 1 4 4 4 e
4 0 0 1 0 4 1 0 0 1 0 0 1 1 1 0 1 1 0 1 1 1 1 0 0 1 1 e
4 4 4 0 1 0 4 0 4 2 1 2 4 4 0 4 4 4 0 4 4 0 3 4 1 4 4 e
9 9 9 9 9 9 9 9 9 9 9 9 9 9 9 9 9 9 9 9 9 9 9 9 9 9 9 e
9 9 9 9 9 9 9 9 9 9 9 9 9 9 9 9 9 9 9 9 9 9 9 9 9 9 9 e
