9 9 9 9 9 9 9 9 9 9 9 9 9 9 9 9 9 9 9 9 9 9 9 9 9 9 9 e
9 9 9 9 9 9 9 9 9 9 9 9 9 9 9 9 9 9 9 9 9 9 9 9 9 9 9 e
1 1 0 1 0 0 1 0 0 4 4 1 1 3 1 0 0 1 0 0 0 0 1 0 1 0 0 e
4 4 4 1 0 0 4 0 4 4 4 1 4 4 4 0 4 4 4 4 1 0 4 4 0 4 0 e
0 1 1 2 1 0 1 1 0 0 2 1 1 1 1 0 0 0 0 1 1 0 1 1 0 1 2 e
1 0 4 4 1 1 0 2 0 1 0 1 4 4 4 4 1 4 4 0 0 0 4 0 4 1 4 e
1 0 1 0 0 0 1 1 1 1 1 1 1 1 0 0 3 0 0 0 0 0 4 0 0 0 1 e
0 4 4 1 4 4 0 4 4 4 1 1 4 1 4 1 0 0 4 0 0 0 4 1 4 0 0 e
3 1 0 1 1 0 1 0 0 1 3 1 0 0 1 0 0 0 1 1 1 0 1 1 1 1 0 e
4 4 3 0 1 1 0 0 4 1 4 1 4 4 4 0 0 4 1 4 1 4 4 4 0 0 2 e
0 1 0 1 4 0 1 4 1 1 0 0 0 0 0 1 2 2 0 1 1 0 4 0 1 0 1 e
0 4 4 4 4 4 4 1 1 1 4 4 0 4 0 3 4 1 2 0 0 0 4 0 4 1 0 e
1 0 1 0 0 0 1 0 1 1 0 1 0 1 1 1 1 1 1 0 1 0 1 1 1 2 3 e
0 0 1 4 0 0 4 4 1 2 0 0 1 1 4 0 4 4 4 0 1 4 1 0 4 4 1 e
0 0 0 1 1 1 1 0 1 1 1 0 2 0 2 1 1 1 1 0 0 0 0 0 1 0 2 e
4 1 1 0 4 0 0 4 4 4 1 4 4 0 1 4 4 4 4 4 1 0 1 4 1 4 0 e
0 1 1 1 1 0 0 0 1 1 1 1 0 1 0 1 2 0 1 1 1 1 0 1 0 0 0 e
1 4 4 0 0 0 4 4 1 4 4 0 4 4 1 2 4 1 4 0 4 1 4 0 1 0 4 e
1 0 0 1 1 1 1 0 0 1 1 0 2 1 0 0 1 0 0 0 1 0 1 1 0 3 0 e
4 1 0 4 4 4 4 4 4 4 1 4 4 4 4 0 4 4 0 1 1 4 1 1 0 0 1 e
0 1 0 0 1 0 1 1 0 2 0 1 0 0 0 0 0 0 1 0 0 1 2 1 0 1 1 e
0 0 4 4 0 0 4 0 0 1 4 1 1 1 4 4 4 4 4 0 4 4 4 4 0 4 1 e
1 0 0 0 0 0 3 1 0 0 0 0 1 1 0 1 0 0 0 1 0 1 0 1 0 0 1 e
4 1 1 1 1 4 4 1 4 1 0 4 1 4 0 4 1 4 4 4 0 4 1 4 1 4 0 e
9 9 9 9 9 9 9 9 9 9 9 9 9 9 9 9 9 9 9 9 9 9 9 9 9 9 9 e
9 9 9 9 9 9 9 9 9 9 9 9 9 9 9 9 9 9 9 9 9 9 9 9 9 9 9 e
